5 1 4 7 7 7 4 9 2 0 
6 8 6 4 7 7 5 5 8 6 
4 6 9 10 6 5 2 4 2 0 
2 5 8 5 9 1 3 6 7 10 
7 7 7 3 6 3 2 8 3 0 
3 5 10 2 10 1 8 8 5 9 
9 1 2 8 2 2 5 1 3 0 
1 2 5 9 5 10 10 4 9 1 
5 3 3 10 4 10 8 3 9 0 
8 2 7 5 1 6 5 10 7 2 
9 1 1 1 6 2 2 3 2 0 
8 3 6 3 1 5 3 2 7 5 
9 4 6 6 6 6 2 10 8 0 
8 2 8 6 10 3 9 2 1 4 
6 7 6 5 4 8 3 6 8 0 
2 8 10 6 10 7 10 5 6 1 
6 6 7 4 7 3 9 9 2 0 
7 8 2 9 1 10 4 7 7 10 
7 7 9 10 3 9 5 4 8 0 
