10 6 2 4 0 
6 7 6 10 4 
3 9 7 1 0 
1 3 9 2 1 
8 4 7 7 0 
5 9 9 7 2 
3 1 6 7 0 
9 5 9 3 9 
9 4 3 9 0 
