4 6 9 9 0
7 7 4 3 3
3 9 7 7 0
5 4 2 7 8
1 1 6 4 0
3 6 2 4 9
8 8 9 2 0
2 9 5 7 3
7 2 5 7 0
